.................
...BAAAA.........
...B.BBB.........
...B.BBB.........
...B...B.........
...B.BBBBB...BBB.
...B.BBB.B...BBB.
...B.BBB.BBB.BBB.
...B.BBB...B.BBB.
...B.BBB...B.BBB.
...B...B...B.B...
...BBB.BBB.B.BBB.
.....B.BBB.B.B.B.
.....B.BBB.BBB.B.
.....B.B.......B.
.....BBBBBBBBBBB.
.................
